ahack379 = Ariana Hackenburg <ahack379@fnal.gov>
andrzejs = Andrzej Szelc <andrzejs@fnal.gov>
baller = Bruce Baller <baller@fnal.gov>
bcarls = Benjamin Carls <bcarls@fnal.gov>
bjpjones = Benjamin Jones <bjpjones@fnal.gov>
blake = Andy Blake <blake@hep.phy.cam.ac.uk>
bpage = Brian Page <bpage@fnal.gov>
brebel = Brian Rebel <brebel@fnal.gov>
cadams = Corey Adams <cadams@fnal.gov>
cbrasco = Christina Brasco <cbrasco@fnal.gov>
cschiu = Christie Chiu <cschiu@fnal.gov>
dmckee = David Mckee <dmckee@fnal.gov>
echurch = Eric Church <echurch@fnal.gov>
ellenk = Ellen Klein <ellenk@fnal.gov>
garren = Lynn Garren <garren@fnal.gov>
georgiak = Georgia Karagiorgi <georgiak@fnal.gov>
greenc = Christopher Green <greenc@fnal.gov>
greenlee = Herbert Greenlee <greenlee@fnal.gov>
guardi = Elena Guardincerri <guardi@fnal.gov>
guenette = Roxanne Guenette <guenette@fnal.gov>
iwai = Eito Iwai <iwai@fnal.gov>
jasaadi = Jonathan Asaadi <jasaadi@fnal.gov>
jti3 = Jonathan Insler <jti3@fnal.gov>
kirby = Michael Kirby <kirby@fnal.gov>
kpartyka = Kinga Partyka <kpartyka@fnal.gov>
kterao = Kazuhiro Terao <kterao@fnal.gov>
lockwitz = Sarah Lockwitz <lockwitz@fnal.gov>
mengel = Marc Mengel <mengel@fnal.gov>
miceli = Tia Miceli <tiamiceli@gmail.com>
mstancar = Michelle Stancari <mstancar@fnal.gov>
palamara = Ornella Palamara <palamara@fnal.gov>
patch = Adam Patch <patch@fnal.gov>
pkryczyn = Pawel Kryczynski <pkryczyn@fnal.gov>
rhatcher = Robert Hatcher <rhatcher@fnal.gov>
rs = Erica Snider <rs@fnal.gov>
saima = Saima Farooq <saima@fnal.gov>
seligman = William Seligman <seligman@fnal.gov>
seongtae = Seong Tae Park <seongtae@fnal.gov>
soderber = Mitchell Soderberg <soderber@fnal.gov>
spitz7 = Joshua Spitz <spitz7@fnal.gov>
strauss = Thomas Strauss <strauss@fnal.gov>
talion = Tyler Alion <talion@fnal.gov>
tjyang = Tingjun Yang <tjyang@fnal.gov>
trj = Thomas Junk <trj@fnal.gov>
wketchum = Wesley Ketchum <wketchum@fnal.gov>
zarko = Zarko Pavlovic <zarko@fnal.gov>
zpli = Zepeng Li <zpli@fnal.gov>
